NO ./assets/textures/xpm/north_wall.xpm
SO ./assets/textures/xpm/south_wall.xpm
WE ./assets/textures/xpm/west_wall.xpm
EA ./assets/textures/xpm/east_wall.xpm

F 164,169,20
C 153,204,255

111111111111111111111
101000001000000000001
10101-101011111110001
100010100010000010001
1111101011111010111-1
100000101000101000001
101111101011101111111
101000001010100000101
10101111101011111-101
101010001010100010101
1011101010101010101-1
100000101010001010001
111111101-11111011101
100000101000100010001
101110101110101110111
101000100000100010101
1-1-11111111111010101
100010000000000010001
10101-111-111111111-1
1N10-0001000000000001
111111111111111111111
