NO ./assets/textures/xpm/north_wall.xpm
SO ./assets/textures/xpm/south_wall.xpm
WE ./assets/textures/xpm/west_wall.xpm
EA ./assets/textures/xpm/east_wall.xpm
F 220, 100, 0
C 225, 30, 0
        1111111111111111111111111
        100-000000110000000000001
        1011000001110000000000001
        1001000000-00000000000001
111111111-11000001110000000000001
10000000001100000111-111111111111
11110111111111011100000010001
1111-111111111011101010010001
11000000110101011100000010001
10000000000000001100000010001
100000000000000011010100-0001
110000011101-1011111011110N0111
11110111 1110101 101111010001
11111111 1111111 111111111111