





WE ./assets/textures/xpm/brick_wall.xpm                          

      NO             ./assets/textures/xpm/brick_wall.xpm
SO ./assets/textures/xpm/brick_wall.xpm     
EA        ./assets/textures/xpm/brick_wall.xpm
            F         51,51,51
                                                 
C    0,191,255

11111111111111111111111111111111111111111111111111111111
100001000000000000000000000000000100000100000000000000001
11001100000000000010000000000100000000100000000000010001
10100010010000000000000000000000100011111000000000000011
100001000000000000000000010001000000000100000000000000001
100011000000000000000000000010010000101100000001000000001
10000100000001111000000000000100000000000000000000000001
10000000000001  10000000000001000000000000000000000010001
10000000000001  10000000100001000010000000000000000000001
10000000000001  10000000000000000000010000001111111011111
10000000000001  10100100000001000000000100001     101
10001100000001  10000100000000000000000100001     101
10000000001001  10000100100000000001000100001     101
10000000000001  10000100001111110000000100001     101
10000000000001  10000100000000000000000000001     101
100001000000011110000010000000000010000000001     101
100000000000000000000000000000000000000000001     101
100000000001111100000000000000000000000000001     101
100010000000000000000000000000000100000000001   1110111111
100000000000000000000000000000011111111000001   10000000001
10000000000001000000000000000001      1000001   10000000001
100000000000000000100000000000011111111000001   10000000001
101010000000000000100000000000000100000000001   10000000001
100110000000000000100000000000000100000000001   10000000001
100010000000010000100010000000000000000000001   11111111111
100000000000000000100000000000000000000000001
1000000100000000000000000000000E0000000000001              
100000000000000000000000000000000000000000011
100000000000000000000000000000000000000000011      
111111111111111111111111111111111111111111111         
