NO ./assets/textures/xpm/tech_wall_north.xpm
SO ./assets/textures/xpm/tech_wall_south.xpm
EA ./assets/textures/xpm/tech_wall_east.xpm
WE ./assets/textures/xpm/tech_wall_west.xpm

F 0,0,0
C 0,30,225

11111111111111
10000000000001
1001-1-1-10001
100-00000-0001
100100N0010001
100-00000-0001
1001-1-1-10001
10000000000001
11111111111111
