NO ./assets/textures/xpm/brick_wall.xpm
SO ./assets/textures/xpm/brick_wall.xpm
WE ./assets/textures/xpm/brick_wall.xpm
EA ./assets/textures/xpm/brick_wall.xpm

F 220,100,0
C 225,30,0

11111111111111
10000000000001
100101-1010001
10000000000001
100000S0000001
10000000000001
100101-1010001
10000000000001
11111111111111
