NOO ./assets/textures/xpm/tech_wall_north.xpm
SO ./assets/textures/xpm/tech_wall_south.xpm
WE ./assets/textures/xpm/tech_wall_west.xpm
NO ./assets/textures/xpm/tech_wall_north.xpm
EA ./assets/textures/xpm/tech_wall_east.xpm

F 220,100,0
C 225,255,0

        1111111111111111111111111
        1000000000110000000000011
        1011000001110000000000001
        1001000000000000000W00001
111111111011000001110000000000001
100000000011000001111101111111111
11110111111111011100000010001
11110111111111011101010010001
11000000110101011100000000001
10000000000000001100000010001
10000000000000001101010010001
1100000111010101111101111000111
11110111 1110101 1 1111 10001
11111111 1111111 111111111111