NO ./assets/textures/xpm/brick_wall.xpm
SO ./assets/textures/xpm/brick_wall.xpm
WE ./assets/textures/xpm/brick_wall.xpm
EA ./assets/textures/xpm/brick_wall.xpm

F 220,100,0
C 225,30,0

11111111111111
10000000000001
10000000000001
1000001-1000001
100010S0100001
10000010000001
10000000000001
10000000000001
11111111111111
