WE ./assets/textures/xpm/brick_wall.xpm                          

      NO             ./assets/textures/xpm/brick_wall.xpm
SO ./assets/textures/xpm/brick_wall.xpm     
EA        ./assets/textures/xpm/brick_wall.xpm
            F         51,51,51
                                                 
C    0,191,255


1111
1001
10S1
1111
