NO ./assets/textures/xpm/brick_wall.xpm
SO ./assets/textures/xpm/brick_wall.xpm
EA ./assets/textures/xpm/brick_wall.xpm
WE ./assets/textures/xpm/brick_wall.xpm
 
C 149,242,223
F 229,241,217

111111111
100000001
100000001
10N000001
100000001
100000001
100000001
100000001
100001111
100001
100001
100001
100001
100001
100001
100001
100001
100001
100001
111111