NO ./assets/textures/xpm/brick_wall.xpm
SO ./assets/textures/xpm/brick_wall.xpm
EA ./assets/textures/xpm/brick_wall.xpm
WE ./assets/textures/xpm/brick_wall.xpm
 
C 149,242,223
F 229,241,217

11111111111111111111111111111111111111111111111
11-10000000000000000000000000000000000000000011
1-W000000000000000000000000000000000000000000-1
11000000000000000000000000000000000000000000011
10000000000000000000000000000000000000000000001
10000000000000000000000000000000000000000000001
10000000000000000000000000000000000000000000001
10000000000000000000000000000000000000000000001
10000000000000000000000000000000000000000000001
10000000000000000000000000000000000000000000001
10000000000000000000000000000000000000000000001
10000000000000000000000000000000000000000000001
10000000000000000000000000000000000000000000001
10000000000000000000000000000000000000000000001
10000000000000000000000000000000000000000000001
10000000000000000000000000000000000000000000001
10000000000000000000000000000000000000000000001
1000000000000000000000000000000000000001-100001
11111111111111111111111111111111111111111111111
100000001
100000001
100000001
100000001
100000001
100000001
100001111
100001
100001
100001
100001
100001
100001
100001
100001
100001
100001
111111