NO ./assets/textures/xpm/tech_wall_east.xpm
SO ./assets/textures/xpm/brick_wall.xpm
EA ./assets/textures/xpm/brick_wall.xpm
WE ./assets/textures/xpm/brick_wall.xpm
 
C 149,242,223
F 229,241,217

11111111111111111111111111111111111111111111111
11010000000000000000000000000000000000000000011
10000000000000000000000000000000000000000000001
11000000000000000000000000000000000000000000011
11010000010100000000000000000000000000000001011
10000000100000000000000000000000000000000000001
11000001010000000000000000000000000000000000011
10000000100000000000000000000000000000000000001
10000000000000000000000000000000000000000000001
10000000000000000000000000000000000000000000001
10000000000000000000000000000000000000000000001
10000000000000000000000000000000000000000000001
10000000000000000000000000000000000000000000001
10000000000000000000000000000000000000000000001
10000000000000000000000000000000000000000000001
10000000000000000000000000000000000000000000001
10000000000000000000000000000000000000000000001
10000000000000000000000000000000000000000000001
11000000000000000000000000000000000000000000001
10000000000000000000000000000000000000000000001
11010000000000000000000000000000000000010100001
11111111111111111111111111111111111111111111111
100000001
100000001
100000001
100000001
100000001
100000001
100001111
100001
100001
100001
100001
100001
100001
100001
100001
100001
100S01
111111